  _      ________      ________ _      
 | |    |  ____\ \    / /  ____| |     
 | |    | |__   \ \  / /| |__  | |     
 | |    |  __|   \ \/ / |  __| | |     
 | |____| |____   \  /  | |____| |____ 
 |______|______|   \/   |______|______|